#####################################
#  ................                 #
#    #######################        #
#             ............          #
#####   ###############             #
#   ......   #  ...............     #
#            ################       #
#                                   #
# ..........                        #
#####################################